OOOOOOOOO
OXXXXXXXO
OXPXTXPXO
OXTXXXTXO
OXXXSXXXO
OXTXXXTXO
OXPXTXPXO
OXXXXXXXO
OOOOOOOOO