OOOOOOOOO
OOOOOOOOO
OOPXTXPOO
OOTXXXTOO
OOXXSXXOO
OOTXXXTOO
OOPXTXPOO
OOOOOOOOO
OOOOOOOOO