PDXXOXDXX
XOXXXXXOD
DXXOOOXXX
XXXOXXOXX
XXXOSXXOX
XXXOOXOXX
XXXOXXXXO
DOXXOOOOO
XXXXXXXDP