PKXXXXXOP
OXXXXXXXK
XXXOXKXXX
OXXOOOXXX
OXKXSXOXX
OXKXXXOXX
XXXOOOXXX
OXXKKXXXK
PKXXXXXOP