PDXXXXDXP
XOXXXXXOD
DXXXDXXXX
XXXDXDXXX
XXXDSDXXX
XXXXDXXXX
XXXXXXXXD
DOXXXXXOX
PXDXXXXDP