PXXXXXXXP
XXXXVXXXX
XXXOXOXXX
XXOXXXOXX
XXOXSXOXX
XXOXXXOXX
XXXOXOXXX
XXXXVXXXX
PXXXXXXXP