PXXXOXXXZ
XOXXOXPOX
XXOXOXOXX
XXXXOXXXX
XXXOSXXXX
XXXXOXXXX
XXOXOXOXX
XOPXOXXOX
ZXXXOXXXP