PDXXOXDXP
XOXXOXXOD
DXXXOXXXX
XXXOOOXOX
XXXOSOXXX
XXXXDXXXO
XXXXXXOXO
DOXXXXXOX
PXXOXXXDP