PXXOOOXXP
XORRRRROX
XHXXXXXBX
OHXXXXXBO
OHXXSXXBO
OHXXXXXBO
XHXXXXXBX
XOLLLLLOX
PXXOOOXXP