PDXXOXDXP
XOXXOXXOD
DXXXOXXXX
XXXOOOXOX
OXXOSOXXX
XOXXDXXXO
XXXXXXOXO
DOXXXOXOX
PXXOXXXDP